"","Zip Code","$1 under $25,000","$100,000 under $200,000","$200,000 or more","$25,000 under $50,000","$50,000 under $75,000","$75,000 under $100,000","Total"
"1",0,3036960,1404280,650530,2263840,1399600,881490,9636700
"2",10001,3460,3090,3100,2480,1980,1490,15600
"3",10002,17140,4410,2280,8820,5200,3050,40900
"4",10003,4060,6340,6930,3200,3580,3050,27160
"5",10004,300,500,800,190,230,230,2250
"6",10005,630,1420,1650,590,780,650,5720
"7",10006,270,630,610,230,330,270,2340
"8",10007,440,640,1620,280,300,260,3540
"9",10009,7930,5530,2520,6080,5330,3650,31040
"10",10010,2170,3920,4170,1910,2250,1790,16210
"11",10011,4200,6730,8080,3060,3290,2850,28210
"12",10012,1990,2690,2800,1400,1620,1320,11820
"13",10013,3600,2190,3940,1940,1550,1180,14400
"14",10014,2210,4560,5110,1690,2010,1980,17560
"15",10016,4320,7450,7040,3950,4830,3860,31450
"16",10017,1630,2660,3370,1250,1390,1230,11530
"17",10018,1210,1280,1500,940,770,600,6300
"18",10019,4490,5810,5950,3540,3490,2600,25880
"19",10021,2930,4800,7310,2070,2620,2470,22200
"20",10022,2490,4470,6340,1740,2160,1920,19120
"21",10023,5190,7350,10500,3490,3430,3060,33020
"22",10024,4840,6110,8980,3130,3130,2640,28830
"23",10025,10460,7660,8170,7500,5930,3920,43640
"24",10026,5920,2160,1220,4530,2670,1450,17950
"25",10027,9380,2850,1760,6820,3950,1970,26730
"26",10028,3370,5450,6730,2420,3200,2870,24040
"27",10029,13590,2210,990,10090,5270,2210,34360
"28",10030,5370,870,290,4060,2070,930,13590
"29",10031,10680,2000,540,8640,4690,1980,28530
"30",10032,11350,1840,440,8730,4510,1930,28800
"31",10033,10270,2250,840,7520,3850,1780,26510
"32",10034,7540,1730,450,5410,3010,1560,19700
"33",10035,6010,1240,460,4380,2250,1070,15410
"34",10036,3760,3910,3140,2820,2450,1940,18020
"35",10037,3350,1100,170,2830,1960,1100,10510
"36",10038,2900,2390,2110,1870,1550,1130,11950
"37",10039,5390,840,230,3930,2080,900,13370
"38",10040,7970,1720,520,5840,3270,1580,20900
"39",10044,1080,900,590,750,680,460,4460
"40",10065,2020,3240,4720,1690,1890,1480,15040
"41",10069,420,610,1340,260,280,220,3130
"42",10075,1960,3160,3990,1270,1640,1520,13540
"43",10128,4900,6760,8340,3690,4290,3380,31360
"44",10162,80,180,300,40,70,50,720
"45",10280,460,1160,1440,310,410,400,4180
"46",10282,200,340,1140,100,130,110,2020
"47",10301,5600,2760,1080,4300,2820,1820,18380
"48",10302,2990,1140,190,2180,1290,750,8540
"49",10303,4640,1330,150,3570,1940,1100,12730
"50",10304,7260,2480,1090,5350,2840,1690,20710
"51",10305,6370,3330,770,4610,2990,2070,20140
"52",10306,7920,5590,1760,5680,4130,3070,28150
"53",10307,1670,1570,730,1090,870,680,6610
"54",10308,3330,3300,930,2540,2040,1650,13790
"55",10309,3760,3680,1460,2700,2150,1720,15470
"56",10310,3830,1870,620,2690,1760,1030,11800
"57",10312,7340,7190,2340,5300,4290,3500,29960
"58",10314,11520,8360,2390,8500,6210,4640,41620
"59",10451,10490,1000,90,8230,3600,1250,24660
"60",10452,17970,830,50,12490,4630,1390,37360
"61",10453,19330,770,40,12860,4420,1320,38740
"62",10454,7820,420,60,5240,1890,540,15970
"63",10455,8560,420,40,6480,2380,710,18590
"64",10456,20560,850,30,13880,4690,1430,41440
"65",10457,16800,740,50,11310,3920,1200,34020
"66",10458,16690,1040,60,11420,4460,1510,35180
"67",10459,10240,580,30,7490,2780,890,22010
"68",10460,12420,720,40,9030,3220,1060,26490
"69",10461,7700,3090,450,6710,4530,2360,24840
"70",10462,13950,3040,230,11770,7670,3530,40190
"71",10463,10740,4880,1810,8160,5570,3250,34410
"72",10464,540,460,200,370,340,270,2180
"73",10465,5790,3380,730,4660,3450,2350,20360
"74",10466,12580,2400,210,10390,5340,2340,33260
"75",10467,19180,2220,160,14690,7170,2730,46150
"76",10468,16900,1200,90,11840,4710,1700,36440
"77",10469,11600,3370,430,9440,5570,2860,33270
"78",10470,2480,1000,200,2020,1420,690,7810
"79",10471,2170,2180,1300,1520,1560,1280,10010
"80",10472,13370,1020,80,9440,3900,1360,29170
"81",10473,11010,2030,180,8910,4610,2120,28860
"82",10474,2360,120,0,1730,640,220,5070
"83",10475,6450,2320,140,6400,5010,2550,22870
"84",10501,160,140,160,90,80,70,700
"85",10502,540,650,930,270,210,230,2830
"86",10504,870,620,1680,380,310,240,4100
"87",10505,240,150,160,140,100,50,840
"88",10506,600,430,1150,220,210,150,2760
"89",10507,840,420,390,470,350,230,2700
"90",10509,2720,2210,1060,1720,1310,1020,10040
"91",10510,940,1000,1770,460,440,320,4930
"92",10511,330,250,110,200,170,130,1190
"93",10512,3040,3060,1120,2220,1850,1460,12750
"94",10514,1080,810,2600,400,330,270,5490
"95",10516,590,700,440,410,330,280,2750
"96",10518,180,150,200,90,60,60,740
"97",10520,1390,1400,1330,890,800,580,6390
"98",10522,1100,1200,1240,690,680,510,5420
"99",10523,1300,960,320,1080,750,560,4970
"100",10524,470,530,390,290,230,200,2110
"101",10526,210,210,230,130,110,80,970
"102",10527,90,90,130,50,40,30,430
"103",10528,1370,1080,1300,910,730,600,5990
"104",10530,1280,1850,1250,940,1030,880,7230
"105",10532,540,640,410,340,340,270,2540
"106",10533,680,770,1230,380,350,310,3720
"107",10535,100,60,30,90,60,50,390
"108",10536,1120,990,1710,520,480,350,5170
"109",10537,320,280,40,270,200,130,1240
"110",10538,1570,1240,3340,710,740,570,8170
"111",10541,3240,3240,1390,2070,1710,1390,13040
"112",10543,2540,1850,1950,1540,1190,870,9940
"113",10546,140,150,220,60,70,60,700
"114",10547,920,860,370,620,540,390,3700
"115",10548,400,420,150,270,260,180,1680
"116",10549,2360,1340,1640,1340,900,650,8230
"117",10550,7460,1420,130,6310,3220,1470,20010
"118",10552,2660,2040,770,2370,2000,1350,11190
"119",10553,1900,750,100,1760,1020,580,6110
"120",10560,500,470,490,300,230,180,2170
"121",10562,4340,3000,1530,3290,2270,1590,16020
"122",10566,4020,1820,480,3180,1960,1210,12670
"123",10567,2290,2510,1620,1450,1180,960,10010
"124",10570,1340,1190,1760,650,630,490,6060
"125",10573,6050,2530,2130,4210,2490,1480,18890
"126",10576,510,490,900,250,190,170,2510
"127",10577,350,200,600,140,140,100,1530
"128",10578,120,120,50,70,50,30,440
"129",10579,990,1140,600,670,590,480,4470
"130",10580,1810,1180,3390,720,640,510,8250
"131",10583,3620,3250,7470,1630,1530,1280,18780
"132",10588,340,370,140,180,180,140,1350
"133",10589,800,1340,820,540,570,550,4620
"134",10590,690,760,860,330,340,260,3240
"135",10591,3070,2000,1850,2450,1560,1000,11930
"136",10594,550,610,490,350,350,230,2580
"137",10595,680,810,690,390,430,290,3290
"138",10597,100,80,210,40,30,20,480
"139",10598,3320,3970,2490,1920,1710,1390,14800
"140",10601,1570,1040,800,1210,860,610,6090
"141",10603,2460,1940,880,1910,1530,1130,9850
"142",10604,1560,980,770,1020,810,550,5690
"143",10605,2180,2210,2310,1370,1220,920,10210
"144",10606,2670,1210,820,1920,1180,680,8480
"145",10607,960,870,540,750,530,420,4070
"146",10701,11160,3300,780,8040,4590,2500,30370
"147",10703,3550,1600,300,2720,1740,1090,11000
"148",10704,4480,3170,690,3800,3170,2070,17380
"149",10705,7250,1780,530,5350,2740,1450,19100
"150",10706,860,980,1280,470,480,430,4500
"151",10707,1130,1240,1010,730,650,540,5300
"152",10708,2130,2570,2780,1260,1500,1230,11470
"153",10709,1140,1120,1030,590,650,500,5030
"154",10710,3270,3160,1050,2590,2320,1740,14130
"155",10801,6300,2870,1160,4380,2780,1750,19240
"156",10803,1330,1110,1940,660,570,460,6070
"157",10804,1410,1490,2570,620,600,490,7180
"158",10805,2500,1580,490,2010,1630,1080,9290
"159",10901,2950,2390,1440,1920,1540,1180,11420
"160",10913,590,610,500,310,310,240,2560
"161",10916,540,600,260,340,260,240,2240
"162",10917,310,210,110,200,140,90,1060
"163",10918,1530,1410,470,980,810,620,5820
"164",10919,170,130,30,130,80,60,600
"165",10920,1120,1110,530,750,600,480,4590
"166",10921,600,500,170,450,320,260,2300
"167",10923,1390,850,230,1150,820,510,4950
"168",10924,1640,1480,720,1130,850,670,6490
"169",10925,630,550,130,450,390,290,2440
"170",10926,480,360,100,430,350,200,1920
"171",10927,2700,490,120,1860,760,370,6300
"172",10928,670,330,60,630,390,230,2310
"173",10930,1180,1060,450,710,560,460,4420
"174",10940,8230,3600,620,6660,3960,2550,25620
"175",10941,2190,1250,270,1750,1190,790,7440
"176",10950,6330,3290,1300,3680,2190,1630,18420
"177",10952,5230,1540,1160,2870,1350,830,12980
"178",10954,3240,2850,1140,2190,1720,1300,12440
"179",10956,3820,3940,2960,2100,1780,1430,16030
"180",10958,470,350,120,280,240,180,1640
"181",10960,1950,1460,980,1470,1050,760,7670
"182",10962,640,630,440,400,320,250,2680
"183",10963,360,280,50,270,180,150,1290
"184",10964,140,160,180,110,90,60,740
"185",10965,1750,2060,1100,1140,1030,850,7930
"186",10968,210,310,240,180,140,140,1220
"187",10969,180,130,50,120,80,80,640
"188",10970,1440,1030,410,1160,810,580,5430
"189",10973,290,280,90,200,170,130,1160
"190",10974,480,410,140,310,260,160,1760
"191",10975,40,30,0,40,30,20,160
"192",10976,300,140,70,130,130,70,840
"193",10977,9870,2390,890,6590,2950,1580,24270
"194",10980,1810,1590,680,1310,990,750,7130
"195",10983,670,820,490,350,380,300,3010
"196",10984,330,330,130,250,180,140,1360
"197",10985,40,40,0,30,40,0,150
"198",10986,250,210,110,180,140,100,990
"199",10987,620,390,330,240,210,150,1940
"200",10989,1040,1250,570,740,690,570,4860
"201",10990,2470,2410,1190,1560,1210,1050,9890
"202",10992,1240,1280,320,860,660,550,4910
"203",10993,980,290,30,730,400,220,2650
"204",10994,910,960,690,470,440,360,3830
"205",10996,400,300,60,110,110,200,1180
"206",10998,390,460,120,290,220,170,1650
"207",11001,3700,3200,1620,2400,1930,1430,14280
"208",11003,7400,3540,510,6580,4080,2570,24680
"209",11004,1830,1400,350,1350,1050,860,6840
"210",11005,150,470,310,140,160,180,1410
"211",11010,3270,3010,930,2300,1970,1450,12930
"212",11020,820,530,780,460,290,220,3100
"213",11021,1970,1990,2130,1170,1090,950,9300
"214",11023,990,750,1050,540,410,370,4110
"215",11024,880,520,810,400,330,220,3160
"216",11030,1810,1430,3540,770,670,530,8750
"217",11040,5320,5340,2930,3280,2770,2250,21890
"218",11050,3680,2750,3930,2070,1550,1150,15130
"219",11096,1650,350,60,1090,540,310,4000
"220",11101,5540,4740,2860,4060,3370,2440,23010
"221",11102,5570,2880,740,4300,3550,2110,19150
"222",11103,6120,2730,640,4550,4040,2430,20510
"223",11104,4330,2270,610,3220,2630,1720,14780
"224",11105,5730,2900,930,4110,3640,2210,19520
"225",11106,6310,3210,840,4860,4020,2470,21710
"226",11109,300,1060,1090,260,350,350,3410
"227",11201,5390,8020,8550,4050,4030,3500,33540
"228",11203,12830,2850,310,12120,6570,3160,37840
"229",11204,14430,2920,1040,9160,4230,2190,33970
"230",11205,5840,2730,1370,4630,2830,1740,19140
"231",11206,14440,2800,690,11560,6380,2780,38650
"232",11207,17860,2130,220,14960,6560,2580,44310
"233",11208,19810,1870,130,15070,6290,2380,45550
"234",11209,9740,6140,2410,6720,5440,3910,34360
"235",11210,9480,3170,1370,8340,4770,2410,29540
"236",11211,8280,5280,2620,6790,5420,3450,31840
"237",11212,16530,1390,90,13220,5380,2080,38690
"238",11213,11220,2010,470,9280,5000,2140,30120
"239",11214,17360,3850,850,10980,5470,3200,41710
"240",11215,5370,7220,6640,4770,4790,3730,32520
"241",11216,8480,3320,1210,7750,6020,3090,29870
"242",11217,3810,4430,3700,3260,3140,2190,20530
"243",11218,11420,4450,1900,7680,4770,2880,33100
"244",11219,17870,2020,800,8910,3140,1600,34340
"245",11220,30880,2250,560,12680,4560,1980,52910
"246",11221,14480,3080,760,13210,7550,3300,42380
"247",11222,4690,4570,2030,4390,4540,2960,23180
"248",11223,13550,3230,1320,8660,4350,2390,33500
"249",11224,8200,1790,340,5440,2790,1430,19990
"250",11225,9500,3020,840,8790,5780,2860,30790
"251",11226,18230,3740,870,16790,9050,4100,52780
"252",11228,7780,2790,1060,4550,2640,1690,20510
"253",11229,13060,5130,1730,8800,5350,3430,37500
"254",11230,13310,4050,1950,9130,5210,3000,36650
"255",11231,3730,3420,3270,2850,2180,1650,17100
"256",11232,5120,1120,330,3350,1860,920,12700
"257",11233,12000,2240,540,10500,5730,2400,33410
"258",11234,12410,6950,2070,10160,6890,4470,42950
"259",11235,14830,4950,1720,9230,5740,3590,40060
"260",11236,15970,4470,500,14990,8480,4370,48780
"261",11237,8460,1500,290,7740,4370,1650,24010
"262",11238,6350,6060,3790,6030,5800,3830,31860
"263",11239,2680,450,0,2400,1470,690,7690
"264",11354,17150,2350,670,6750,3260,1830,32010
"265",11355,33140,2220,480,10960,4040,2090,52930
"266",11356,5880,1160,220,3320,1630,920,13130
"267",11357,6050,4030,1600,3810,2780,2140,20410
"268",11358,7940,2730,910,4250,2470,1640,19940
"269",11360,2470,2400,1090,1680,1340,1130,10110
"270",11361,4700,2350,890,2830,1940,1490,14200
"271",11362,2520,1920,790,1480,1220,1000,8930
"272",11363,930,680,520,530,470,350,3480
"273",11364,5710,3250,1090,3640,2570,1990,18250
"274",11365,8220,2980,800,5150,3040,2020,22210
"275",11366,2310,1120,470,1380,920,610,6810
"276",11367,7460,2300,730,4360,2690,1670,19210
"277",11368,22950,1750,140,14530,6210,2450,48030
"278",11369,7560,1240,150,5090,2620,1280,17940
"279",11370,5430,1460,290,3470,1990,1120,13760
"280",11372,13230,3650,970,8650,5260,2720,34480
"281",11373,23740,3050,480,13700,6780,3370,51120
"282",11374,7250,3910,1030,4810,3910,2590,23500
"283",11375,8070,7960,4140,5540,5290,4320,35320
"284",11377,17980,4200,850,11700,6820,3850,45400
"285",11378,6010,2550,590,4350,2740,1650,17890
"286",11379,5060,3500,980,3590,2860,1980,17970
"287",11385,16610,5490,850,13490,8670,4560,49670
"288",11411,3110,1460,170,2980,1960,1210,10890
"289",11412,6270,1930,210,6180,3460,1860,19910
"290",11413,6770,2630,310,6390,3880,2180,22160
"291",11414,3470,2710,690,2770,2260,1690,13590
"292",11415,2540,1710,440,1950,1780,1180,9600
"293",11416,5290,760,50,4050,1930,840,12920
"294",11417,5400,1600,190,4530,2430,1360,15510
"295",11418,7160,1580,310,5290,2670,1350,18360
"296",11419,10970,1440,150,7540,3390,1630,25120
"297",11420,9030,1970,230,7200,3890,2030,24350
"298",11421,7940,1740,190,6210,3260,1550,20890
"299",11422,5210,1960,250,4910,2970,1670,16970
"300",11423,5450,1440,380,4570,2480,1360,15680
"301",11426,2980,1770,410,2020,1430,1000,9610
"302",11427,3660,1720,450,2940,1880,1320,11970
"303",11428,3390,1210,140,2780,1640,960,10120
"304",11429,4540,1290,100,4110,2360,1250,13650
"305",11432,11080,2510,730,7700,4080,2110,28210
"306",11433,6770,1060,80,5590,2640,1170,17310
"307",11434,10930,2800,240,10400,6320,3140,33830
"308",11435,9790,2440,270,7730,4350,2260,26840
"309",11436,3420,790,50,3120,1740,890,10010
"310",11501,2690,2590,1030,1950,1690,1260,11210
"311",11507,910,910,740,550,430,360,3900
"312",11509,260,270,320,160,130,130,1270
"313",11510,4980,4100,1310,3660,2690,2060,18800
"314",11514,550,580,250,430,380,300,2490
"315",11516,910,680,560,530,370,310,3360
"316",11518,1330,1340,660,940,870,680,5820
"317",11520,8420,3150,690,6540,3610,2230,24640
"318",11530,3100,2980,4610,1410,1440,1100,14640
"319",11542,4280,2280,1120,3190,1850,1210,13930
"320",11545,1360,1150,1750,680,590,490,6020
"321",11548,210,130,120,130,80,50,720
"322",11550,11890,2350,410,8810,4040,2030,29530
"323",11552,3550,2700,1150,2650,1930,1400,13380
"324",11553,5360,1220,160,4440,2280,1200,14660
"325",11554,4970,4730,1740,3410,2730,2170,19750
"326",11557,940,850,920,550,460,370,4090
"327",11558,1240,940,290,820,670,490,4450
"328",11559,1090,590,940,500,420,280,3820
"329",11560,820,630,830,490,380,240,3390
"330",11561,4330,4640,2320,3040,2850,2440,19620
"331",11563,2690,2850,1170,1820,1680,1380,11590
"332",11565,930,1390,730,620,580,500,4750
"333",11566,3990,4620,3590,2310,2080,1700,18290
"334",11568,390,220,670,200,140,100,1720
"335",11570,3240,2940,3340,1880,1620,1340,14360
"336",11572,3810,4180,2040,2330,2060,1740,16160
"337",11575,3800,750,60,2860,1470,760,9700
"338",11576,1350,1130,2370,610,510,420,6390
"339",11577,1350,1170,1590,730,630,530,6000
"340",11579,560,580,570,320,300,240,2570
"341",11580,6380,4460,1000,4930,3690,2610,23070
"342",11581,2720,2550,1130,1980,1560,1250,11190
"343",11590,8050,4220,1790,6370,3550,2220,26200
"344",11596,1210,1340,990,770,610,530,5450
"345",11598,1320,1160,1740,670,540,430,5860
"346",11691,9540,1570,390,7160,3320,1590,23570
"347",11692,3570,760,130,2780,1400,650,9290
"348",11693,1920,780,120,1440,970,620,5850
"349",11694,2260,1860,890,1640,1330,930,8910
"350",11697,470,700,310,310,320,310,2420
"351",11701,4860,1960,600,4090,2410,1380,15300
"352",11702,1690,1970,1170,1090,1000,810,7730
"353",11703,2350,2030,370,1940,1600,1150,9440
"354",11704,5900,3950,740,4860,3590,2380,21420
"355",11705,1000,1100,690,570,490,410,4260
"356",11706,10520,4380,1150,9390,5320,3030,33790
"357",11709,860,820,510,590,450,400,3630
"358",11710,4000,4610,2460,2670,2380,1850,17970
"359",11713,1780,810,280,1410,840,540,5660
"360",11714,3220,2970,1000,2130,1840,1320,12480
"361",11715,530,680,330,370,290,240,2440
"362",11716,1390,1270,420,1060,830,640,5610
"363",11717,11960,1930,160,11920,5040,2230,33240
"364",11718,360,440,400,180,170,170,1720
"365",11719,370,380,190,280,240,180,1640
"366",11720,4040,3250,890,3060,2160,1620,15020
"367",11721,730,860,760,380,350,300,3380
"368",11722,6880,1710,200,6420,3170,1670,20050
"369",11724,370,270,620,140,160,90,1650
"370",11725,3590,3820,2260,2120,1760,1470,15020
"371",11726,4100,1250,210,3440,1690,960,11650
"372",11727,4140,2860,490,3530,2580,1760,15360
"373",11729,4390,3070,590,3350,2460,1680,15540
"374",11730,1780,1930,900,1320,1040,820,7790
"375",11731,3930,3960,2180,2330,1940,1550,15890
"376",11732,420,460,380,230,220,200,1910
"377",11733,1990,2110,2040,1110,880,720,8850
"378",11735,4430,4010,1360,3260,2730,1950,17740
"379",11738,2330,1850,410,1750,1260,980,8580
"380",11740,1220,1080,840,670,560,440,4810
"381",11741,3500,3560,1020,2600,2190,1730,14600
"382",11742,1740,1550,530,1270,1100,810,7000
"383",11743,5180,4920,4620,3090,2590,2060,22460
"384",11746,10040,6250,4530,6710,4230,2930,34690
"385",11747,2520,2500,2410,1490,1320,990,11230
"386",11749,510,300,70,460,330,200,1870
"387",11751,1910,1710,740,1450,1190,860,7860
"388",11752,1420,1230,310,1040,800,600,5400
"389",11753,1390,1290,1820,750,580,480,6310
"390",11754,2420,2490,1150,1570,1250,990,9870
"391",11755,1570,1520,580,1130,930,690,6420
"392",11756,5670,5630,1310,4390,3400,2640,23040
"393",11757,6400,4800,990,5200,3840,2680,23910
"394",11758,6860,7180,3820,4560,3940,3140,29500
"395",11762,2690,3310,1750,1480,1450,1190,11870
"396",11763,4240,2880,600,3490,2340,1630,15180
"397",11764,1480,1740,940,880,750,600,6390
"398",11765,50,50,130,40,20,30,320
"399",11766,1400,1680,1010,840,730,560,6220
"400",11767,1780,1890,970,1060,870,740,7310
"401",11768,2570,2640,2500,1250,1220,990,11170
"402",11769,1120,1340,560,780,720,570,5090
"403",11771,1250,970,1150,770,620,440,5200
"404",11772,6370,4260,990,5290,3740,2490,23140
"405",11776,3710,2650,710,2660,1760,1340,12830
"406",11777,1140,1160,840,700,560,480,4880
"407",11778,1700,1470,360,1230,980,730,6470
"408",11779,5180,4460,930,4030,3180,2260,20040
"409",11780,1990,1770,1520,1180,920,740,8120
"410",11782,1880,2070,1150,1210,1050,820,8180
"411",11783,2520,3120,1460,1630,1480,1220,11430
"412",11784,3640,2480,360,2900,2090,1460,12930
"413",11786,790,820,520,470,320,280,3200
"414",11787,4370,4670,2740,2400,2160,1700,18040
"415",11788,2100,2230,1110,1410,1130,920,8900
"416",11789,1000,870,190,710,620,470,3860
"417",11790,1720,1700,1230,980,710,600,6940
"418",11791,2750,2640,3360,1370,1170,950,12240
"419",11792,1000,1170,650,610,500,440,4370
"420",11793,3780,4590,2430,2260,2080,1810,16950
"421",11795,3080,3500,1630,1950,1740,1270,13170
"422",11796,450,550,180,300,250,210,1940
"423",11797,990,910,1610,510,480,360,4860
"424",11798,3280,820,150,2940,1300,640,9130
"425",11801,6770,4390,1150,4870,3340,2390,22910
"426",11803,3160,3750,3250,1760,1650,1290,14860
"427",11804,530,640,570,270,240,230,2480
"428",11901,4760,1620,420,3540,2010,1110,13460
"429",11933,1040,730,260,740,500,380,3650
"430",11934,1140,1030,430,750,500,390,4240
"431",11935,480,420,290,330,250,200,1970
"432",11937,2780,1430,1400,1790,1140,730,9270
"433",11939,130,100,90,90,60,70,540
"434",11940,740,650,310,500,380,270,2850
"435",11941,320,360,170,240,170,160,1420
"436",11942,740,540,360,450,340,280,2710
"437",11944,720,360,230,540,310,190,2350
"438",11946,2410,1210,510,1690,1090,710,7620
"439",11948,190,140,90,110,70,60,660
"440",11949,2060,1740,800,1220,980,700,7500
"441",11950,2710,1050,110,2180,1250,800,8100
"442",11951,2290,810,100,1790,1080,630,6700
"443",11952,670,540,310,460,380,240,2600
"444",11953,1930,1200,250,1720,1170,810,7080
"445",11954,820,400,270,630,380,200,2700
"446",11955,470,320,110,400,300,200,1800
"447",11957,110,90,100,60,50,40,450
"448",11958,130,70,50,90,70,40,450
"449",11961,1960,1450,320,1460,1210,850,7250
"450",11963,1060,760,750,690,550,370,4180
"451",11967,4010,2200,290,3290,2140,1410,13340
"452",11968,1630,920,940,1020,680,460,5650
"453",11971,790,680,420,520,400,290,3100
"454",11976,250,170,340,180,120,90,1150
"455",11977,400,300,250,200,160,100,1410
"456",11978,630,310,330,380,270,170,2090
"457",11980,600,670,160,460,440,350,2680
"458",12008,50,70,0,50,30,30,230
"459",12009,900,950,290,720,550,480,3890
"460",12010,4840,1450,270,4040,1980,1160,13740
"461",12015,430,350,110,370,270,210,1740
"462",12017,50,50,0,40,30,20,190
"463",12018,950,980,240,800,610,480,4060
"464",12019,1700,2300,670,1380,1170,1030,8250
"465",12020,4560,3560,930,3760,2870,2040,17720
"466",12022,120,70,0,110,60,60,420
"467",12023,240,210,20,220,170,130,990
"468",12025,760,440,80,690,460,310,2740
"469",12027,500,580,170,300,250,250,2050
"470",12028,160,110,0,150,100,60,580
"471",12029,130,100,50,100,80,70,530
"472",12031,40,0,0,40,30,0,110
"473",12032,140,70,0,130,80,70,490
"474",12033,970,950,190,900,660,490,4160
"475",12035,120,50,0,120,80,40,410
"476",12037,590,270,90,460,270,180,1860
"477",12041,50,60,0,50,60,30,250
"478",12042,70,30,0,50,50,30,230
"479",12043,1020,430,70,870,480,320,3190
"480",12046,90,80,0,90,60,40,360
"481",12047,3180,1630,380,3190,1930,1070,11380
"482",12051,540,290,60,460,280,190,1820
"483",12052,200,170,0,170,150,110,800
"484",12053,510,500,100,450,410,280,2250
"485",12054,1930,2320,1110,1350,1240,1050,9000
"486",12056,270,270,50,230,180,140,1140
"487",12057,260,120,0,190,130,80,780
"488",12058,230,120,0,160,110,90,710
"489",12059,200,180,30,180,140,100,830
"490",12060,160,140,60,120,110,80,670
"491",12061,1060,1190,380,940,790,600,4960
"492",12062,200,160,20,190,140,110,820
"493",12063,90,60,30,40,40,30,290
"494",12064,70,0,0,70,40,40,220
"495",12065,5440,5270,1790,4610,3490,2530,23130
"496",12066,270,190,0,220,170,120,970
"497",12067,190,160,30,140,130,120,770
"498",12068,390,190,0,400,230,150,1360
"499",12070,190,90,30,170,130,80,690
"500",12071,50,0,0,40,20,30,140
"501",12072,360,200,0,350,190,150,1250
"502",12074,360,330,60,340,230,210,1530
"503",12075,400,310,100,340,180,170,1500
"504",12076,180,90,0,130,110,80,590
"505",12077,730,920,400,520,470,370,3410
"506",12078,3690,850,130,3040,1440,810,9960
"507",12083,550,350,40,440,290,230,1900
"508",12084,470,450,110,530,440,370,2370
"509",12085,60,0,0,60,40,30,190
"510",12086,270,160,0,240,190,130,990
"511",12087,200,120,0,130,110,70,630
"512",12090,890,330,50,810,440,300,2820
"513",12092,200,80,0,140,90,50,560
"514",12093,240,100,0,190,110,60,700
"515",12094,290,200,20,310,200,130,1150
"516",12095,1790,630,80,1720,890,550,5660
"517",12106,350,260,100,260,210,150,1330
"518",12108,50,40,0,60,50,20,220
"519",12110,2440,2210,540,2150,1830,1230,10400
"520",12116,260,110,0,240,130,70,810
"521",12117,450,180,40,470,250,160,1550
"522",12118,2190,1760,430,1960,1280,870,8490
"523",12120,80,50,0,70,40,30,270
"524",12121,230,210,30,220,140,130,960
"525",12122,620,240,40,530,330,210,1970
"526",12123,640,480,120,630,430,310,2610
"527",12125,240,80,30,220,100,60,730
"528",12130,120,100,0,140,90,60,510
"529",12134,550,280,50,470,280,190,1820
"530",12136,100,80,50,70,70,60,430
"531",12137,190,160,30,220,160,120,880
"532",12138,410,200,40,350,230,190,1420
"533",12139,40,40,0,20,30,0,130
"534",12140,190,220,40,180,130,120,880
"535",12143,650,410,40,660,420,290,2470
"536",12144,2840,1780,330,2900,2030,1330,11210
"537",12147,60,60,0,60,50,60,290
"538",12148,590,670,350,310,310,260,2490
"539",12149,360,130,20,280,150,90,1030
"540",12150,120,90,0,100,100,60,470
"541",12151,110,120,30,100,80,80,520
"542",12153,90,130,0,90,90,50,450
"543",12154,350,290,50,350,250,190,1480
"544",12155,270,90,0,210,140,90,800
"545",12156,100,90,20,90,70,60,430
"546",12157,540,300,50,470,330,220,1910
"547",12158,770,700,180,700,530,390,3270
"548",12159,960,1130,870,620,540,410,4530
"549",12160,120,80,0,110,90,60,460
"550",12164,80,50,0,70,40,30,270
"551",12165,40,50,30,30,30,30,210
"552",12166,180,70,0,210,110,80,650
"553",12167,410,120,20,270,170,110,1100
"554",12168,260,130,30,230,150,110,910
"555",12169,50,50,0,60,30,20,210
"556",12170,660,440,110,620,400,330,2560
"557",12173,240,120,30,180,150,90,810
"558",12175,120,60,0,80,50,60,370
"559",12176,30,30,0,30,40,0,130
"560",12180,7770,2970,620,6730,3860,2230,24180
"561",12182,2460,810,100,2100,1140,660,7270
"562",12183,460,110,0,490,250,120,1430
"563",12184,1000,690,200,700,490,370,3450
"564",12185,240,170,30,230,160,130,960
"565",12186,710,870,350,590,480,400,3400
"566",12187,120,60,0,100,60,30,370
"567",12188,1460,1080,230,1520,990,680,5960
"568",12189,2810,1110,270,2880,1610,760,9440
"569",12190,100,50,0,100,60,30,340
"570",12192,210,130,0,180,120,80,720
"571",12193,240,190,20,240,200,130,1020
"572",12194,40,20,0,30,30,0,120
"573",12196,370,370,100,280,220,190,1530
"574",12197,330,140,0,280,190,90,1030
"575",12198,970,880,230,810,700,500,4090
"576",12202,2280,130,0,1450,480,160,4500
"577",12203,3560,2240,600,3320,2430,1530,13680
"578",12204,1080,450,210,1160,730,390,4020
"579",12205,3860,2340,320,3830,2740,1830,14920
"580",12206,3450,300,50,2250,780,300,7130
"581",12207,380,80,0,260,170,70,960
"582",12208,2870,1550,360,2710,1800,1030,10320
"583",12209,1690,520,50,1680,940,480,5360
"584",12210,1900,280,90,1660,660,300,4890
"585",12211,1260,1460,910,930,850,660,6070
"586",12302,3520,3120,540,3090,2470,1790,14530
"587",12303,4610,2390,620,3810,2340,1520,15290
"588",12304,3740,940,110,3320,1620,810,10540
"589",12305,820,150,50,810,340,170,2340
"590",12306,3940,2130,320,3920,2490,1610,14410
"591",12307,1700,30,0,990,230,60,3010
"592",12308,2600,450,80,2110,910,420,6570
"593",12309,3350,3920,1630,2610,2170,1820,15500
"594",12401,5750,2100,530,4520,2430,1590,16920
"595",12404,510,290,120,370,240,190,1720
"596",12405,120,50,0,100,50,30,350
"597",12406,120,40,0,70,40,20,290
"598",12407,40,0,0,40,30,30,140
"599",12409,180,80,70,70,60,60,520
"600",12410,70,30,0,20,40,0,160
"601",12411,60,50,0,70,50,30,260
"602",12412,120,70,0,60,50,30,330
"603",12413,500,180,0,420,230,130,1460
"604",12414,1540,600,120,1300,780,470,4810
"605",12416,50,0,0,20,30,0,100
"606",12418,60,40,0,70,40,30,240
"607",12419,90,90,0,70,50,40,340
"608",12421,50,50,0,30,40,0,170
"609",12422,40,30,0,30,40,0,140
"610",12423,170,80,0,140,80,50,520
"611",12424,40,20,0,30,30,0,120
"612",12427,90,30,0,50,40,20,230
"613",12428,1090,260,50,710,370,250,2730
"614",12430,180,80,0,100,80,50,490
"615",12431,240,140,0,180,130,90,780
"616",12433,60,40,20,40,50,0,210
"617",12434,120,30,0,80,50,30,310
"618",12435,40,30,0,40,60,0,170
"619",12439,80,30,0,50,40,0,200
"620",12440,280,160,70,240,140,100,990
"621",12442,180,70,20,100,50,40,460
"622",12443,460,460,150,420,300,230,2020
"623",12444,50,50,0,30,40,0,170
"624",12446,740,350,80,550,320,260,2300
"625",12448,50,30,0,0,30,0,110
"626",12449,510,230,30,420,290,170,1650
"627",12451,250,120,0,250,150,90,860
"628",12454,50,30,0,20,30,0,130
"629",12455,250,90,20,210,120,80,770
"630",12456,140,40,0,110,70,50,410
"631",12457,130,50,30,70,40,30,350
"632",12458,400,160,0,300,180,120,1160
"633",12460,50,30,0,30,40,0,150
"634",12461,260,140,50,160,120,90,820
"635",12463,230,110,20,210,120,80,770
"636",12464,160,50,30,100,60,50,450
"637",12466,450,260,40,350,230,200,1530
"638",12468,210,60,0,130,90,50,540
"639",12469,100,60,0,70,60,40,330
"640",12470,80,30,0,80,40,20,250
"641",12472,260,130,30,190,150,70,830
"642",12473,160,90,0,90,70,60,470
"643",12474,180,70,30,140,80,70,570
"644",12477,2900,1370,320,2180,1330,970,9070
"645",12480,80,50,0,70,40,20,260
"646",12481,190,110,50,130,100,90,670
"647",12482,140,30,0,110,50,30,360
"648",12484,380,310,130,290,200,130,1440
"649",12485,210,70,0,130,70,40,520
"650",12486,190,170,30,190,130,90,800
"651",12487,460,260,60,350,210,170,1510
"652",12491,310,160,60,240,150,120,1040
"653",12492,40,30,0,40,0,20,130
"654",12494,80,90,0,80,60,40,350
"655",12495,30,50,0,30,0,20,130
"656",12496,280,100,40,160,100,80,760
"657",12498,700,450,290,430,310,230,2410
"658",12501,280,140,60,300,150,110,1040
"659",12502,130,90,40,90,90,60,500
"660",12503,80,70,0,70,40,30,290
"661",12508,2410,1590,420,2180,1440,1030,9070
"662",12513,150,110,40,120,90,70,580
"663",12514,320,380,140,220,190,170,1420
"664",12515,240,130,30,210,110,90,810
"665",12516,230,130,30,180,130,70,770
"666",12517,70,40,0,50,40,0,200
"667",12518,750,660,300,590,410,340,3050
"668",12520,400,420,190,250,230,180,1670
"669",12521,190,130,60,180,110,90,760
"670",12522,640,340,70,600,400,230,2280
"671",12523,270,120,20,250,150,110,920
"672",12524,1920,1880,580,1490,1350,1000,8220
"673",12525,500,370,130,350,270,190,1810
"674",12526,490,320,120,460,280,180,1850
"675",12528,1930,1350,340,1510,1110,810,7050
"676",12529,350,180,120,300,180,100,1230
"677",12531,360,380,150,310,220,170,1590
"678",12533,3150,3310,1590,2080,1600,1410,13140
"679",12534,2670,870,300,2160,1200,670,7870
"680",12538,1920,1250,250,1560,1100,690,6770
"681",12540,940,960,480,640,460,370,3850
"682",12542,790,620,170,620,510,310,3020
"683",12543,450,230,30,420,300,190,1620
"684",12545,560,430,250,440,300,250,2230
"685",12546,460,170,90,360,200,140,1420
"686",12547,450,280,90,370,230,160,1580
"687",12548,220,160,20,180,110,90,780
"688",12549,1340,1150,380,960,740,610,5180
"689",12550,9320,3540,880,6860,3770,2310,26680
"690",12553,3710,2470,610,3070,2150,1530,13540
"691",12561,2210,1440,570,1420,990,710,7340
"692",12563,1220,770,280,610,510,350,3740
"693",12564,910,810,340,670,470,360,3560
"694",12565,270,80,0,230,100,50,730
"695",12566,1580,1040,240,1080,800,580,5320
"696",12567,380,200,80,290,200,150,1300
"697",12569,1320,1100,360,1060,760,590,5190
"698",12570,880,960,390,490,450,390,3560
"699",12571,1270,970,370,920,660,500,4690
"700",12572,1120,950,590,830,580,530,4600
"701",12575,290,310,120,230,140,140,1230
"702",12577,290,290,100,170,150,130,1130
"703",12578,290,270,110,230,170,120,1190
"704",12580,520,390,160,360,250,220,1900
"705",12581,280,180,70,190,160,130,1010
"706",12582,830,660,230,390,280,250,2640
"707",12583,360,190,60,240,140,120,1110
"708",12585,120,100,50,80,60,50,460
"709",12586,1840,1240,250,1400,970,660,6360
"710",12589,2280,1400,340,1430,990,740,7180
"711",12590,5070,4080,1060,3770,2920,2230,19130
"712",12592,160,70,20,160,80,60,550
"713",12594,530,360,70,470,310,230,1970
"714",12601,7030,2060,470,5230,2550,1520,18860
"715",12603,5610,4600,1370,4250,3210,2550,21590
"716",12701,2040,350,80,1620,660,350,5100
"717",12719,110,60,20,120,70,50,430
"718",12721,950,570,110,710,430,320,3090
"719",12723,250,110,40,180,110,80,770
"720",12725,40,0,0,40,20,40,140
"721",12726,130,80,20,110,80,50,470
"722",12729,280,80,20,240,130,90,840
"723",12732,110,90,0,90,60,30,380
"724",12733,120,0,0,80,30,30,260
"725",12734,180,60,0,160,70,40,510
"726",12737,250,160,30,180,120,100,840
"727",12738,40,0,0,30,20,30,120
"728",12740,240,150,40,230,160,120,940
"729",12741,40,20,0,30,30,0,120
"730",12742,60,0,0,50,30,30,170
"731",12743,50,40,0,50,40,0,180
"732",12746,200,90,0,120,110,50,570
"733",12747,220,110,0,210,120,60,720
"734",12748,260,150,40,230,130,100,910
"735",12751,200,30,0,130,60,30,450
"736",12752,50,30,0,50,40,0,170
"737",12754,1110,270,60,890,400,200,2930
"738",12758,630,240,70,450,260,180,1830
"739",12759,310,60,0,190,70,40,670
"740",12760,80,30,0,50,30,20,210
"741",12762,90,40,0,80,30,30,270
"742",12763,110,60,0,110,80,30,390
"743",12764,210,120,50,200,130,80,790
"744",12765,100,100,0,100,80,40,420
"745",12766,70,0,0,50,20,30,170
"746",12768,150,70,0,100,70,50,440
"747",12770,30,0,0,40,0,30,100
"748",12771,2270,880,170,1720,890,590,6520
"749",12775,360,300,90,230,230,150,1360
"750",12776,280,120,30,200,130,90,850
"751",12777,100,80,20,70,60,40,370
"752",12779,380,80,20,350,120,70,1020
"753",12780,370,190,20,250,160,130,1120
"754",12783,200,90,0,160,90,60,600
"755",12786,100,50,20,70,50,30,320
"756",12787,60,40,0,50,30,30,210
"757",12788,330,120,20,290,140,110,1010
"758",12789,280,70,20,240,120,70,800
"759",12790,680,310,60,620,420,250,2340
"760",12791,80,60,0,70,50,40,300
"761",12792,60,40,0,60,0,30,190
"762",12801,2650,760,150,2300,1130,660,7650
"763",12803,1460,580,40,1220,750,520,4570
"764",12804,4330,2490,710,3180,2110,1430,14250
"765",12808,60,50,0,0,30,20,160
"766",12809,490,230,40,430,250,180,1620
"767",12810,120,30,0,90,60,30,330
"768",12814,300,150,60,210,110,60,890
"769",12815,140,70,30,130,70,50,490
"770",12816,660,310,40,500,320,250,2080
"771",12817,380,190,30,280,180,130,1190
"772",12819,50,20,0,40,30,0,140
"773",12821,70,0,0,50,30,30,180
"774",12822,960,330,40,850,470,310,2960
"775",12823,40,30,0,30,40,0,140
"776",12824,120,70,30,110,50,40,420
"777",12827,610,240,30,530,330,220,1960
"778",12828,1490,580,60,1390,790,520,4830
"779",12831,2370,1940,560,1810,1240,990,8910
"780",12832,910,310,30,760,450,320,2780
"781",12833,630,440,150,510,310,250,2290
"782",12834,950,560,90,850,480,370,3300
"783",12835,380,170,20,320,230,140,1260
"784",12836,100,50,0,80,40,30,300
"785",12837,110,40,0,100,70,50,370
"786",12838,100,30,0,110,60,30,330
"787",12839,2200,560,50,2000,1020,580,6410
"788",12842,190,90,0,170,90,60,600
"789",12843,90,40,0,60,60,0,250
"790",12844,30,30,30,20,30,0,140
"791",12845,980,430,170,560,360,240,2740
"792",12846,520,190,40,430,250,180,1610
"793",12847,110,60,0,90,60,30,350
"794",12849,90,40,0,70,40,30,270
"795",12850,400,290,70,320,210,150,1440
"796",12851,60,0,0,40,20,30,150
"797",12852,60,40,0,50,40,20,210
"798",12853,230,80,0,210,90,60,670
"799",12855,30,0,0,30,20,20,100
"800",12857,90,30,0,60,50,30,260
"801",12859,270,170,30,230,180,120,1000
"802",12860,150,30,0,100,50,30,360
"803",12861,80,60,0,70,50,40,300
"804",12863,90,90,0,80,60,40,360
"805",12865,510,180,30,450,270,170,1610
"806",12866,5240,4110,2230,3710,2790,2110,20190
"807",12870,280,90,30,200,140,90,830
"808",12871,620,330,70,500,320,220,2060
"809",12873,100,70,0,100,70,50,390
"810",12878,120,30,0,90,50,40,330
"811",12883,790,260,40,610,340,220,2260
"812",12885,830,190,20,600,330,180,2150
"813",12886,60,20,0,20,30,0,130
"814",12887,710,250,0,620,350,230,2160
"815",12901,4680,1710,380,4170,2080,1250,14270
"816",12903,230,160,40,220,210,120,980
"817",12910,230,90,0,210,120,80,730
"818",12912,300,90,20,300,180,100,990
"819",12913,140,90,0,160,90,60,540
"820",12914,110,30,0,90,60,40,330
"821",12916,310,80,0,290,160,100,940
"822",12917,210,60,0,140,100,90,600
"823",12918,270,210,0,340,220,120,1160
"824",12919,480,220,0,480,240,160,1580
"825",12920,320,160,0,280,170,130,1060
"826",12921,390,200,30,320,190,140,1270
"827",12923,70,20,0,50,40,30,210
"828",12926,310,80,0,270,160,80,900
"829",12928,300,130,0,270,160,100,960
"830",12930,100,30,0,80,60,40,310
"831",12932,180,70,20,180,120,50,620
"832",12934,120,50,0,140,80,50,440
"833",12935,210,100,0,180,120,70,680
"834",12936,100,60,0,80,40,30,310
"835",12937,210,50,0,170,90,60,580
"836",12941,220,120,0,150,110,80,680
"837",12942,90,70,20,60,50,50,340
"838",12943,70,50,0,50,50,0,220
"839",12944,610,180,30,580,270,190,1860
"840",12945,100,50,0,90,60,40,340
"841",12946,970,370,150,750,400,220,2860
"842",12950,150,40,0,120,60,30,400
"843",12952,90,30,0,80,40,30,270
"844",12953,1660,550,90,1340,780,450,4870
"845",12955,50,20,0,40,40,0,150
"846",12956,190,50,0,140,100,50,530
"847",12957,240,70,0,210,100,60,680
"848",12958,270,120,0,250,150,100,890
"849",12959,200,80,0,170,90,50,590
"850",12960,160,80,0,150,90,50,530
"851",12961,30,0,0,30,20,20,100
"852",12962,730,500,70,650,420,360,2730
"853",12965,80,30,0,60,30,30,230
"854",12966,400,130,0,370,230,120,1250
"855",12967,170,60,0,120,70,50,470
"856",12969,50,30,0,50,30,30,190
"857",12970,40,0,0,40,30,40,150
"858",12972,850,580,90,720,520,360,3120
"859",12974,240,80,0,200,100,60,680
"860",12978,50,20,0,60,50,0,180
"861",12979,390,150,30,310,180,120,1180
"862",12980,190,60,0,170,70,60,550
"863",12981,260,190,0,310,190,140,1090
"864",12983,1100,520,140,1000,480,370,3610
"865",12985,170,60,0,130,70,60,490
"866",12986,740,320,50,740,510,260,2620
"867",12987,40,20,0,30,30,0,120
"868",12989,110,80,0,120,80,60,450
"869",12992,720,300,30,720,380,270,2420
"870",12993,260,100,30,180,130,80,780
"871",12996,290,100,30,250,150,90,910
"872",12997,200,100,0,170,90,60,620
"873",12998,100,0,0,70,30,40,240
"874",13021,6400,2330,470,4790,2790,1720,18500
"875",13026,160,120,20,140,100,80,620
"876",13027,4610,3550,1070,3640,2670,1910,17450
"877",13028,180,80,0,140,110,60,570
"878",13029,980,750,200,800,570,370,3670
"879",13030,550,290,70,540,330,210,1990
"880",13031,2250,1720,460,1900,1440,970,8740
"881",13032,1870,770,130,1620,970,600,5960
"882",13033,500,250,20,450,330,210,1760
"883",13034,230,150,30,200,140,90,840
"884",13035,1050,870,470,670,490,390,3940
"885",13036,1290,620,80,1130,680,480,4280
"886",13037,1240,830,170,1100,700,490,4530
"887",13039,2460,2000,460,1930,1360,1050,9260
"888",13040,410,120,0,330,240,110,1210
"889",13041,1490,1260,230,1240,930,820,5970
"890",13042,290,150,0,290,180,110,1020
"891",13044,380,180,30,330,190,130,1240
"892",13045,3780,1420,240,3190,1740,1040,11410
"893",13052,250,120,0,240,140,90,840
"894",13053,660,380,70,510,300,190,2110
"895",13054,230,90,0,200,120,90,730
"896",13057,2280,1090,220,2150,1310,800,7850
"897",13060,440,210,30,360,240,140,1420
"898",13061,100,100,20,130,90,60,500
"899",13063,210,190,50,170,140,110,870
"900",13066,1600,1520,990,1100,880,670,6760
"901",13068,780,390,70,700,410,300,2650
"902",13069,3810,1170,150,3000,1670,1050,10850
"903",13071,130,70,0,130,70,50,450
"904",13072,120,40,0,110,50,30,350
"905",13073,890,410,50,790,510,350,3000
"906",13074,620,240,0,510,300,190,1860
"907",13076,300,170,0,300,200,120,1090
"908",13077,1010,450,80,900,580,380,3400
"909",13078,1120,1020,770,720,550,460,4640
"910",13080,460,270,30,420,300,200,1680
"911",13081,130,90,20,100,90,60,490
"912",13082,710,340,40,610,370,260,2330
"913",13083,230,120,0,200,130,90,770
"914",13084,550,390,100,550,390,250,2230
"915",13088,3320,1450,240,3500,2270,1280,12060
"916",13090,4370,2810,540,3810,2690,1810,16030
"917",13092,330,170,0,340,180,110,1130
"918",13101,370,130,0,370,210,130,1210
"919",13103,80,0,0,50,40,0,170
"920",13104,1830,1730,1380,1170,900,710,7720
"921",13108,860,710,170,570,440,360,3110
"922",13110,310,240,60,260,190,140,1200
"923",13111,270,70,0,210,120,70,740
"924",13112,260,190,30,210,130,110,930
"925",13114,890,460,60,800,460,340,3010
"926",13116,450,310,60,480,300,190,1790
"927",13118,730,350,40,640,420,260,2440
"928",13120,430,100,0,330,200,100,1160
"929",13122,150,80,20,130,80,60,520
"930",13126,4840,2160,360,3430,2080,1570,14440
"931",13131,550,230,20,500,320,180,1800
"932",13132,590,300,40,510,290,210,1940
"933",13135,1020,470,100,760,440,300,3090
"934",13136,80,20,0,60,50,0,210
"935",13140,610,210,0,550,340,190,1900
"936",13141,100,50,0,90,60,30,330
"937",13142,950,420,50,720,470,280,2890
"938",13143,390,160,0,320,200,130,1200
"939",13144,190,50,0,150,90,50,530
"940",13145,290,110,0,200,140,100,840
"941",13146,310,90,0,260,180,100,940
"942",13147,150,60,0,140,90,50,490
"943",13148,1700,620,110,1360,780,450,5020
"944",13152,1050,890,650,650,500,420,4160
"945",13155,80,30,0,80,40,30,260
"946",13156,250,170,0,210,140,100,870
"947",13158,190,70,0,190,110,70,630
"948",13159,690,520,160,590,360,300,2620
"949",13160,280,140,30,260,170,110,990
"950",13164,350,310,70,260,180,130,1300
"951",13165,1760,490,60,1460,820,460,5050
"952",13166,780,350,40,680,470,280,2600
"953",13167,450,250,30,460,260,170,1620
"954",13202,1090,170,70,510,290,120,2250
"955",13203,3010,340,130,2060,700,290,6530
"956",13204,4020,280,60,2550,930,380,8220
"957",13205,3590,290,30,2300,850,350,7410
"958",13206,3030,510,60,2930,1370,630,8530
"959",13207,2500,470,100,1850,860,470,6250
"960",13208,4660,330,0,3160,1050,470,9670
"961",13209,2220,750,100,2040,1140,670,6920
"962",13210,2850,550,140,1730,750,410,6430
"963",13211,1190,160,0,1190,530,210,3280
"964",13212,3260,1200,160,3210,1880,1160,10870
"965",13214,1050,740,190,840,540,430,3790
"966",13215,1970,1750,640,1230,970,730,7290
"967",13219,2290,1380,200,2030,1590,980,8470
"968",13224,1440,610,280,1010,550,340,4230
"969",13302,270,60,0,200,90,60,680
"970",13303,150,110,0,140,90,60,550
"971",13304,230,190,60,200,140,100,920
"972",13308,510,190,0,460,230,170,1560
"973",13309,850,310,40,730,470,270,2670
"974",13310,110,40,0,80,40,30,300
"975",13314,80,0,0,60,20,50,210
"976",13315,170,90,0,170,90,70,590
"977",13316,900,340,30,820,450,300,2840
"978",13317,520,170,20,510,270,190,1680
"979",13318,180,80,0,200,90,60,610
"980",13319,160,40,0,140,80,30,450
"981",13320,310,110,20,250,140,100,930
"982",13322,150,90,0,160,90,60,550
"983",13323,1290,910,300,1070,760,540,4870
"984",13324,280,130,0,270,160,100,940
"985",13325,150,50,0,110,70,40,420
"986",13326,800,360,260,540,350,250,2560
"987",13327,280,120,0,290,160,110,960
"988",13328,150,100,0,140,90,60,540
"989",13329,520,150,0,530,250,160,1610
"990",13331,40,30,0,30,30,0,130
"991",13332,360,130,0,320,200,100,1110
"992",13334,190,60,0,170,90,60,570
"993",13335,250,80,0,190,120,80,720
"994",13337,120,70,40,110,50,40,430
"995",13338,180,80,0,180,100,60,600
"996",13339,950,240,20,790,410,230,2640
"997",13340,1190,450,70,1120,590,360,3780
"998",13343,240,100,0,210,120,80,750
"999",13346,500,380,150,400,250,220,1900
"1000",13348,200,90,0,170,90,60,610
"1001",13350,1480,360,50,1190,570,360,4010
"1002",13354,390,270,30,420,270,200,1580
"1003",13355,140,60,0,100,70,30,400
"1004",13357,1580,450,50,1450,710,440,4680
"1005",13360,90,40,0,70,20,30,250
"1006",13361,120,30,0,80,40,30,300
"1007",13363,330,170,30,260,170,120,1080
"1008",13365,1260,420,70,1090,570,360,3770
"1009",13367,1130,460,80,930,630,420,3650
"1010",13368,160,40,0,140,100,50,490
"1011",13402,210,80,0,210,110,60,670
"1012",13403,810,480,100,550,410,250,2600
"1013",13406,80,40,0,60,50,30,260
"1014",13407,810,230,20,730,410,240,2440
"1015",13408,330,150,0,300,180,130,1090
"1016",13409,350,120,0,320,180,140,1110
"1017",13411,500,130,0,410,210,130,1380
"1018",13413,1970,1590,660,1560,1120,890,7790
"1019",13416,290,140,20,270,160,130,1010
"1020",13417,560,130,30,560,300,150,1730
"1021",13420,290,100,50,200,120,90,850
"1022",13421,2110,730,150,1760,990,540,6280
"1023",13424,330,180,20,280,200,130,1140
"1024",13425,290,100,0,250,140,90,870
"1025",13428,230,80,0,160,100,60,630
"1026",13431,240,150,20,230,150,90,880
"1027",13433,280,50,0,200,130,60,720
"1028",13437,60,0,0,50,40,30,180
"1029",13438,430,250,30,460,290,200,1660
"1030",13439,560,190,40,520,260,150,1720
"1031",13440,6160,2140,310,5220,2890,1770,18490
"1032",13450,30,0,0,30,20,20,100
"1033",13452,650,200,0,560,310,170,1890
"1034",13454,120,40,0,100,80,30,370
"1035",13456,550,380,70,460,320,210,1990
"1036",13459,290,120,0,280,160,110,960
"1037",13460,700,200,30,660,350,180,2120
"1038",13461,430,290,50,370,260,200,1600
"1039",13464,190,40,0,180,90,40,540
"1040",13468,70,30,0,60,60,0,220
"1041",13469,90,80,0,100,60,50,380
"1042",13470,80,0,0,90,50,50,270
"1043",13471,470,130,0,390,220,130,1340
"1044",13473,100,40,0,80,60,40,320
"1045",13476,480,210,30,440,270,170,1600
"1046",13477,210,80,0,150,110,70,620
"1047",13478,420,200,20,430,260,170,1500
"1048",13480,510,210,30,470,230,170,1620
"1049",13483,60,0,0,50,0,30,140
"1050",13485,170,60,0,130,80,60,500
"1051",13486,110,60,0,100,70,50,390
"1052",13488,50,0,0,50,0,20,120
"1053",13489,100,40,0,80,50,40,310
"1054",13490,190,110,0,190,120,100,710
"1055",13491,540,210,30,450,280,170,1680
"1056",13492,1610,1100,230,1450,930,690,6010
"1057",13493,310,80,0,220,170,80,860
"1058",13494,60,0,0,40,30,30,160
"1059",13495,340,100,0,360,180,100,1080
"1060",13501,7170,1010,230,4930,1690,850,15880
"1061",13502,5710,1230,180,4240,2000,1190,14550
"1062",13601,6030,1620,330,4410,2280,1310,15980
"1063",13603,780,200,0,1580,720,280,3560
"1064",13605,580,310,40,480,320,200,1930
"1065",13606,390,170,30,320,180,160,1250
"1066",13607,340,120,40,230,140,90,960
"1067",13608,210,70,0,150,100,80,610
"1068",13612,350,170,0,330,220,120,1190
"1069",13613,370,140,0,270,160,100,1040
"1070",13614,40,0,0,30,30,0,100
"1071",13616,250,50,0,280,120,50,750
"1072",13617,1050,620,140,1000,630,410,3850
"1073",13618,300,130,30,210,150,100,920
"1074",13619,1290,430,60,1280,680,420,4160
"1075",13620,280,100,0,220,190,100,890
"1076",13621,90,30,0,70,40,30,260
"1077",13622,330,170,30,260,180,100,1070
"1078",13624,700,360,80,500,320,230,2190
"1079",13625,270,140,20,220,150,120,920
"1080",13626,260,140,0,290,160,120,970
"1081",13630,160,60,0,140,90,60,510
"1082",13634,550,280,40,480,290,210,1850
"1083",13635,140,50,0,120,70,50,430
"1084",13636,40,0,0,50,30,20,140
"1085",13637,630,160,0,860,340,120,2110
"1086",13638,70,0,0,50,30,20,170
"1087",13640,60,60,20,40,30,30,240
"1088",13642,1220,410,40,950,560,350,3530
"1089",13646,330,100,20,210,150,80,890
"1090",13648,280,140,0,270,180,120,990
"1091",13650,200,80,20,150,80,70,600
"1092",13652,270,80,0,220,120,90,780
"1093",13654,260,100,0,270,140,100,870
"1094",13655,780,80,0,540,210,90,1700
"1095",13656,410,120,0,350,180,110,1170
"1096",13658,310,150,0,310,190,130,1090
"1097",13659,70,30,0,60,50,30,240
"1098",13660,270,110,0,220,140,90,830
"1099",13661,190,100,0,170,120,80,660
"1100",13662,2500,780,120,1920,1070,660,7050
"1101",13664,70,60,0,60,40,30,260
"1102",13665,100,40,0,120,50,40,350
"1103",13667,550,140,0,380,220,160,1450
"1104",13668,470,220,0,390,230,170,1480
"1105",13669,2100,770,140,1720,1010,580,6320
"1106",13670,40,0,0,50,0,30,120
"1107",13672,90,40,0,90,60,30,310
"1108",13673,320,110,0,280,160,100,970
"1109",13676,1560,760,170,1160,720,480,4850
"1110",13679,270,110,20,220,140,100,860
"1111",13680,150,60,0,130,80,40,460
"1112",13681,120,30,0,90,60,40,340
"1113",13682,110,70,0,100,80,50,410
"1114",13684,140,60,0,140,100,60,500
"1115",13685,330,190,50,270,220,140,1200
"1116",13687,60,40,0,80,40,20,240
"1117",13690,110,40,0,90,60,30,330
"1118",13691,420,200,0,350,220,130,1320
"1119",13693,80,60,0,70,40,40,290
"1120",13694,210,130,30,190,130,90,780
"1121",13696,40,0,0,50,0,20,110
"1122",13697,310,120,0,280,150,80,940
"1123",13730,410,130,0,330,220,140,1230
"1124",13731,150,80,30,110,70,40,480
"1125",13732,1000,790,180,740,570,450,3730
"1126",13733,730,260,20,570,390,250,2220
"1127",13734,310,120,0,290,160,100,980
"1128",13736,390,140,0,310,190,100,1130
"1129",13739,140,50,0,110,70,50,420
"1130",13740,80,60,0,40,40,30,250
"1131",13743,490,210,20,500,280,190,1690
"1132",13744,170,80,0,120,90,60,520
"1133",13746,380,180,20,290,230,120,1220
"1134",13748,610,220,30,450,280,200,1790
"1135",13750,170,50,0,150,90,30,490
"1136",13751,30,0,0,30,40,0,100
"1137",13752,110,60,0,90,60,30,350
"1138",13753,610,260,60,500,290,190,1910
"1139",13754,510,150,0,340,190,130,1320
"1140",13755,200,70,0,170,100,60,600
"1141",13756,80,0,0,40,40,30,190
"1142",13757,150,80,0,130,80,50,490
"1143",13760,7060,3050,680,5390,3210,2040,21430
"1144",13775,230,130,0,200,130,70,760
"1145",13776,90,40,0,70,50,40,290
"1146",13777,130,50,0,110,60,40,390
"1147",13778,780,350,50,770,460,280,2690
"1148",13780,130,60,0,150,90,50,480
"1149",13782,100,50,0,90,40,30,310
"1150",13783,420,90,30,250,160,90,1040
"1151",13786,50,30,0,40,40,0,160
"1152",13787,500,160,0,470,220,140,1490
"1153",13788,150,60,0,110,70,40,430
"1154",13790,3240,740,160,2360,1270,690,8460
"1155",13795,560,200,30,510,270,170,1740
"1156",13796,170,70,0,170,70,70,550
"1157",13797,290,110,0,290,140,90,920
"1158",13801,190,40,0,160,90,50,530
"1159",13802,140,60,0,90,60,40,390
"1160",13803,590,220,0,520,310,200,1840
"1161",13804,60,20,0,60,60,0,200
"1162",13807,180,100,0,160,90,70,600
"1163",13808,260,120,0,200,120,80,780
"1164",13809,240,70,0,200,110,80,700
"1165",13810,190,70,0,130,100,50,540
"1166",13811,630,250,40,500,340,210,1970
"1167",13812,320,130,0,290,170,110,1020
"1168",13813,140,50,0,120,60,40,410
"1169",13815,2070,660,140,1690,910,510,5980
"1170",13820,2800,1000,190,2040,1150,770,7950
"1171",13825,510,180,20,440,240,160,1550
"1172",13827,1730,740,180,1280,810,560,5300
"1173",13830,690,220,30,590,340,210,2080
"1174",13832,90,20,0,80,60,0,250
"1175",13833,640,210,40,520,300,210,1920
"1176",13835,200,70,0,180,100,70,620
"1177",13838,720,200,0,550,290,170,1930
"1178",13839,190,70,0,170,110,70,610
"1179",13841,70,30,0,70,50,0,220
"1180",13842,70,30,0,60,30,30,220
"1181",13843,240,90,0,220,120,80,750
"1182",13844,120,30,0,100,60,30,340
"1183",13846,50,0,0,50,20,30,150
"1184",13849,600,220,30,620,340,200,2010
"1185",13850,2740,1950,740,2040,1450,1110,10030
"1186",13856,930,260,30,750,450,250,2670
"1187",13861,110,60,0,80,50,40,340
"1188",13862,630,240,20,510,310,190,1900
"1189",13863,80,0,0,50,40,30,200
"1190",13864,200,50,0,160,80,50,540
"1191",13865,870,330,40,700,440,330,2710
"1192",13901,3240,1080,210,2170,1230,730,8660
"1193",13903,3000,1050,310,2250,1180,710,8500
"1194",13904,1540,390,50,1230,660,320,4190
"1195",13905,4380,1120,290,2860,1530,870,11050
"1196",14001,1330,790,130,1170,780,590,4790
"1197",14004,1520,1030,110,1270,870,690,5490
"1198",14005,310,140,0,250,170,110,980
"1199",14006,1430,610,100,1330,760,530,4760
"1200",14008,270,110,0,160,120,70,730
"1201",14009,830,300,40,740,420,300,2630
"1202",14011,880,410,40,730,540,360,2960
"1203",14012,350,160,0,290,180,130,1110
"1204",14013,250,100,0,210,120,60,740
"1205",14020,3600,1140,180,2910,1520,910,10260
"1206",14024,220,110,0,190,130,80,730
"1207",14025,420,350,60,350,260,180,1620
"1208",14026,120,90,0,130,50,70,460
"1209",14028,240,110,20,170,120,100,760
"1210",14030,220,110,0,220,130,80,760
"1211",14031,1410,980,640,890,640,530,5090
"1212",14032,1210,1100,730,650,470,430,4590
"1213",14033,270,250,80,250,190,160,1200
"1214",14034,240,110,0,240,160,110,860
"1215",14036,710,390,50,590,400,280,2420
"1216",14037,160,120,0,130,120,70,600
"1217",14040,340,190,30,240,190,130,1120
"1218",14042,620,150,0,510,300,180,1760
"1219",14043,3880,1690,150,3820,2260,1420,13220
"1220",14047,870,460,90,810,540,420,3190
"1221",14048,2650,480,50,1920,840,530,6470
"1222",14051,2750,2770,1560,1510,1190,1070,10850
"1223",14052,2440,2080,780,1640,1270,1010,9220
"1224",14054,190,100,0,160,100,90,640
"1225",14055,190,110,30,140,140,90,700
"1226",14057,1150,860,160,890,600,490,4150
"1227",14058,270,160,0,270,170,130,1000
"1228",14059,1290,1150,340,950,680,620,5030
"1229",14060,70,0,0,60,40,40,210
"1230",14062,540,190,20,420,230,170,1570
"1231",14063,1670,820,150,1210,740,550,5140
"1232",14065,250,80,0,210,160,90,790
"1233",14066,160,50,0,130,90,60,490
"1234",14067,800,370,40,620,360,300,2490
"1235",14068,970,890,350,550,450,370,3580
"1236",14069,120,100,0,100,90,50,460
"1237",14070,740,220,30,660,400,240,2290
"1238",14072,2920,2490,750,2150,1560,1310,11180
"1239",14075,6370,4350,960,5190,3640,2750,23260
"1240",14080,550,410,60,500,330,250,2100
"1241",14081,490,140,30,400,180,120,1360
"1242",14082,60,50,0,60,50,30,250
"1243",14085,980,1030,210,700,560,540,4020
"1244",14086,4770,4240,950,3560,2800,2090,18410
"1245",14091,160,80,0,190,90,60,580
"1246",14092,1690,1130,340,1210,880,710,5960
"1247",14094,8200,3530,580,6680,3810,2610,25410
"1248",14098,460,150,20,410,230,140,1410
"1249",14101,310,70,0,240,130,90,840
"1250",14102,180,130,30,140,100,90,670
"1251",14103,1780,450,50,1460,750,450,4940
"1252",14105,700,270,30,580,350,240,2170
"1253",14108,880,370,50,750,470,320,2840
"1254",14111,470,230,30,400,260,190,1580
"1255",14113,100,60,0,100,60,50,370
"1256",14120,6790,3540,660,5830,3610,2500,22930
"1257",14125,520,190,30,470,280,210,1700
"1258",14127,4070,3530,1820,2900,2150,1710,16180
"1259",14129,190,70,0,170,140,70,640
"1260",14131,790,420,50,630,420,290,2600
"1261",14132,910,500,60,760,450,350,3030
"1262",14134,60,0,0,40,30,40,170
"1263",14136,790,260,40,650,370,240,2350
"1264",14138,260,80,0,260,150,80,830
"1265",14139,310,240,50,240,200,140,1180
"1266",14141,1130,540,90,930,600,430,3720
"1267",14143,190,100,0,170,120,110,690
"1268",14145,210,130,0,200,130,110,780
"1269",14150,6560,2630,260,6120,3860,2550,21980
"1270",14167,210,130,0,220,150,100,810
"1271",14170,290,250,60,270,200,160,1230
"1272",14171,300,130,0,280,160,110,980
"1273",14172,480,270,50,360,220,210,1590
"1274",14174,800,560,170,610,440,350,2930
"1275",14201,2250,290,90,1490,570,250,4940
"1276",14202,580,190,210,470,230,100,1780
"1277",14203,320,100,50,230,150,70,920
"1278",14204,1800,160,30,1040,430,160,3620
"1279",14206,4090,410,20,3230,1340,620,9710
"1280",14207,5250,240,0,3550,970,370,10380
"1281",14208,2230,110,0,1310,410,170,4230
"1282",14209,1180,340,240,990,520,230,3500
"1283",14210,2850,250,0,2180,880,400,6560
"1284",14211,5480,180,0,2920,700,270,9550
"1285",14212,2600,130,0,1460,430,170,4790
"1286",14213,4720,400,80,3280,1040,440,9960
"1287",14214,3200,830,340,2170,990,560,8090
"1288",14215,8760,630,50,5590,1870,740,17640
"1289",14216,3380,1410,450,3160,1990,1110,11500
"1290",14217,3430,1520,220,3350,2040,1290,11850
"1291",14218,3750,550,50,2710,1360,730,9150
"1292",14219,1920,680,50,1780,1060,640,6130
"1293",14220,3910,1240,100,3710,1940,1110,12010
"1294",14221,7040,6450,2740,4790,3660,3280,27960
"1295",14222,1600,800,540,1690,990,480,6100
"1296",14223,3420,1910,230,3140,2220,1560,12480
"1297",14224,6100,3770,490,5440,3580,2670,22050
"1298",14225,5660,1540,100,5820,3190,1780,18090
"1299",14226,4410,2580,1000,3170,2200,1560,14920
"1300",14227,3560,1420,120,3430,2100,1420,12050
"1301",14228,3240,1590,450,2330,1370,1000,9980
"1302",14301,2790,160,0,1530,470,210,5160
"1303",14303,1290,70,0,790,220,100,2470
"1304",14304,5250,1690,210,4310,2370,1510,15340
"1305",14305,3290,530,70,2090,900,510,7390
"1306",14411,1930,490,70,1570,860,510,5430
"1307",14414,1000,610,90,890,510,350,3450
"1308",14416,500,300,30,470,340,230,1870
"1309",14418,150,80,0,160,80,60,530
"1310",14420,2630,1270,180,2090,1190,880,8240
"1311",14422,300,170,20,260,190,120,1060
"1312",14423,660,370,40,610,390,270,2340
"1313",14424,4380,2420,720,3390,2080,1420,14410
"1314",14425,1880,1160,170,1580,1030,750,6570
"1315",14427,250,120,0,260,160,110,900
"1316",14428,1210,910,120,1020,720,560,4540
"1317",14432,750,340,50,750,430,280,2600
"1318",14433,630,190,20,640,370,160,2010
"1319",14435,370,250,60,320,250,170,1420
"1320",14437,1450,490,60,1200,780,420,4400
"1321",14441,60,20,0,50,30,0,160
"1322",14445,1230,320,50,1310,710,390,4010
"1323",14450,5500,5370,1880,3950,2970,2440,22110
"1324",14454,920,620,160,620,500,340,3160
"1325",14456,3150,990,210,2470,1280,750,8850
"1326",14462,90,60,0,70,40,30,290
"1327",14464,1090,430,50,940,590,360,3460
"1328",14466,230,120,20,210,150,110,840
"1329",14467,1470,730,120,1270,810,550,4950
"1330",14468,2540,1900,350,2170,1490,1240,9690
"1331",14469,850,500,90,710,500,280,2930
"1332",14470,1090,420,40,1120,610,440,3720
"1333",14471,410,190,50,350,240,140,1380
"1334",14472,1160,1010,580,730,540,410,4430
"1335",14475,70,60,0,40,30,0,200
"1336",14476,330,170,0,300,170,110,1080
"1337",14477,220,120,0,210,130,80,760
"1338",14478,100,90,30,80,80,50,430
"1339",14480,150,60,0,130,60,40,440
"1340",14481,250,120,0,210,170,110,860
"1341",14482,1250,570,110,1090,660,450,4130
"1342",14485,610,350,50,470,320,220,2020
"1343",14486,40,30,0,40,40,0,150
"1344",14487,840,520,130,690,470,360,3010
"1345",14489,1100,300,30,980,500,320,3230
"1346",14502,1500,1020,180,1180,810,600,5290
"1347",14504,320,80,0,290,150,70,910
"1348",14505,770,360,30,620,420,320,2520
"1349",14506,160,180,100,70,70,60,640
"1350",14507,210,80,0,180,100,70,640
"1351",14510,830,220,0,620,340,200,2210
"1352",14512,720,310,60,580,330,220,2220
"1353",14513,2300,580,60,2010,1060,560,6570
"1354",14514,880,590,90,770,530,360,3220
"1355",14516,280,130,20,310,190,110,1040
"1356",14517,400,160,0,360,210,140,1270
"1357",14519,1600,1290,240,1500,940,720,6290
"1358",14521,420,130,30,380,190,110,1260
"1359",14522,1410,530,90,1280,730,460,4500
"1360",14525,370,190,0,340,230,180,1310
"1361",14526,2640,2600,970,1910,1470,1200,10790
"1362",14527,1980,660,170,1520,900,550,5780
"1363",14530,800,270,30,700,420,260,2480
"1364",14532,630,280,30,630,400,240,2210
"1365",14533,210,130,0,200,150,80,770
"1366",14534,3610,4240,3430,1900,1710,1480,16370
"1367",14536,100,30,0,70,60,30,290
"1368",14541,320,140,40,280,170,100,1050
"1369",14543,370,370,110,360,230,220,1660
"1370",14544,290,90,30,250,160,100,920
"1371",14546,640,360,80,670,450,310,2510
"1372",14548,610,270,30,550,320,180,1960
"1373",14550,220,90,0,220,140,80,750
"1374",14551,840,220,30,820,400,230,2540
"1375",14555,130,70,30,120,60,60,470
"1376",14559,2520,1750,440,2020,1450,1080,9260
"1377",14560,300,170,0,230,180,110,990
"1378",14561,410,170,20,380,220,160,1360
"1379",14564,2120,1830,1180,1360,990,740,8220
"1380",14568,790,630,90,680,500,410,3100
"1381",14569,950,360,50,800,480,330,2970
"1382",14571,250,100,0,180,90,60,680
"1383",14572,770,230,30,620,380,230,2260
"1384",14580,7390,6220,1870,5560,4120,3230,28390
"1385",14585,50,0,0,40,20,20,130
"1386",14586,1630,1140,160,1360,970,700,5960
"1387",14589,1230,560,110,970,580,390,3840
"1388",14590,760,230,30,640,370,200,2230
"1389",14591,220,110,0,200,160,110,800
"1390",14604,390,130,100,340,220,90,1270
"1391",14605,2750,40,20,1310,210,60,4390
"1392",14606,5310,850,70,4460,1910,1010,13610
"1393",14607,2450,580,260,2980,1360,490,8120
"1394",14608,2640,150,30,1510,410,150,4890
"1395",14609,7940,1390,150,6570,3160,1460,20670
"1396",14610,1810,1300,770,1830,1220,740,7670
"1397",14611,3830,120,0,2150,550,170,6820
"1398",14612,5320,2770,500,4840,2940,1960,18330
"1399",14613,3140,130,0,1990,530,170,5960
"1400",14614,80,30,30,80,60,20,300
"1401",14615,3210,430,20,3010,1100,520,8290
"1402",14616,5020,1130,130,4910,2430,1340,14960
"1403",14617,3270,2220,350,2850,2100,1520,12310
"1404",14618,2420,2370,1580,1600,1470,1120,10560
"1405",14619,2960,250,30,2340,860,350,6790
"1406",14620,3460,1050,250,3460,1910,830,10960
"1407",14621,7120,180,20,4260,990,310,12880
"1408",14622,1850,760,130,2030,1260,710,6740
"1409",14623,3200,890,90,2950,1740,960,9830
"1410",14624,5560,2970,370,5360,3480,2360,20100
"1411",14625,1420,1270,420,1090,820,650,5670
"1412",14626,4740,2310,450,4280,2570,1680,16030
"1413",14701,6950,1350,210,4470,2170,1270,16420
"1414",14706,900,450,110,660,390,260,2770
"1415",14709,230,80,0,160,110,70,650
"1416",14710,520,210,40,380,250,180,1580
"1417",14711,240,80,0,200,120,60,700
"1418",14712,520,280,90,330,220,140,1580
"1419",14714,70,30,0,40,50,0,190
"1420",14715,430,100,0,300,180,100,1110
"1421",14716,400,80,0,310,140,100,1030
"1422",14717,100,40,0,80,50,30,300
"1423",14718,270,120,0,230,140,100,860
"1424",14719,460,160,0,430,240,130,1420
"1425",14723,150,70,0,160,100,70,550
"1426",14724,360,110,0,270,170,120,1030
"1427",14726,170,40,0,110,60,30,410
"1428",14727,800,260,50,610,340,240,2300
"1429",14728,150,80,0,110,70,40,450
"1430",14729,130,50,0,110,70,40,400
"1431",14731,240,130,70,170,110,80,800
"1432",14733,620,150,0,540,300,160,1770
"1433",14735,400,100,0,260,160,100,1020
"1434",14736,80,40,0,50,30,30,230
"1435",14737,640,170,0,450,280,170,1710
"1436",14738,520,170,30,450,300,190,1660
"1437",14739,450,90,0,320,170,70,1100
"1438",14740,170,50,0,130,100,80,530
"1439",14741,320,130,0,250,130,80,910
"1440",14743,280,100,0,200,120,80,780
"1441",14744,150,60,0,100,90,60,460
"1442",14747,330,100,0,300,160,80,970
"1443",14748,110,20,0,100,30,30,290
"1444",14750,710,360,150,530,350,240,2340
"1445",14753,190,30,0,130,80,50,480
"1446",14754,80,20,0,70,50,40,260
"1447",14755,420,130,0,350,200,100,1200
"1448",14757,470,200,30,340,220,140,1400
"1449",14760,3310,790,180,2170,1200,660,8310
"1450",14767,230,80,0,210,130,70,720
"1451",14769,170,50,0,100,50,40,410
"1452",14770,450,160,0,360,210,130,1310
"1453",14772,530,170,30,460,270,180,1640
"1454",14775,430,100,0,320,180,90,1120
"1455",14777,100,40,0,90,40,30,300
"1456",14779,1200,160,30,1020,380,190,2980
"1457",14781,350,100,0,220,140,100,910
"1458",14782,300,110,0,260,190,100,960
"1459",14784,160,30,0,120,70,40,420
"1460",14787,800,250,40,560,320,230,2200
"1461",14801,810,240,20,520,360,230,2180
"1462",14802,140,70,0,80,50,40,380
"1463",14803,190,100,0,120,90,50,550
"1464",14804,190,100,0,150,110,60,610
"1465",14805,160,80,0,150,80,60,530
"1466",14806,330,130,0,260,150,110,980
"1467",14807,440,170,30,350,260,140,1390
"1468",14808,110,20,0,70,40,30,270
"1469",14809,350,110,0,320,170,100,1050
"1470",14810,1810,520,50,1400,770,480,5030
"1471",14812,530,180,0,390,250,170,1520
"1472",14813,350,120,0,270,150,110,1000
"1473",14814,280,220,80,180,140,120,1020
"1474",14815,140,70,0,100,70,40,420
"1475",14816,110,50,0,70,60,30,320
"1476",14817,370,190,30,350,240,110,1290
"1477",14818,250,110,40,230,150,110,890
"1478",14819,100,0,0,80,40,50,270
"1479",14820,80,20,0,70,60,40,270
"1480",14821,490,190,30,390,270,180,1550
"1481",14822,150,50,0,120,100,60,480
"1482",14823,550,200,0,490,260,170,1670
"1483",14824,110,30,0,100,50,40,330
"1484",14825,140,40,0,100,70,40,390
"1485",14826,300,120,0,240,150,90,900
"1486",14830,2890,1360,530,2160,1540,980,9460
"1487",14836,130,70,0,120,90,60,470
"1488",14837,810,220,40,600,330,200,2200
"1489",14838,250,120,0,230,150,90,840
"1490",14839,120,30,0,80,50,30,310
"1491",14840,420,240,80,350,230,170,1490
"1492",14841,150,90,0,120,60,50,470
"1493",14842,110,60,0,90,60,30,350
"1494",14843,2090,590,80,1510,870,510,5650
"1495",14845,2880,1710,530,2280,1630,1100,10130
"1496",14846,100,30,0,80,60,30,300
"1497",14847,350,120,20,310,200,120,1120
"1498",14850,6580,3780,2060,5590,3070,1940,23020
"1499",14853,70,0,0,30,30,0,130
"1500",14855,130,40,0,110,50,30,360
"1501",14858,200,130,0,160,120,90,700
"1502",14859,170,60,0,160,90,60,540
"1503",14860,170,60,0,140,70,40,480
"1504",14861,210,60,0,180,90,50,590
"1505",14864,200,70,0,160,90,50,570
"1506",14865,400,150,20,300,170,110,1150
"1507",14867,870,310,40,810,430,270,2730
"1508",14869,180,70,0,170,100,70,590
"1509",14870,1260,830,390,850,700,460,4490
"1510",14871,540,390,60,430,360,290,2070
"1511",14872,90,20,0,80,50,30,270
"1512",14873,360,100,0,300,170,110,1040
"1513",14874,50,20,0,50,0,0,120
"1514",14877,80,0,0,60,40,40,220
"1515",14878,110,50,0,80,50,30,320
"1516",14879,310,110,0,240,190,100,950
"1517",14880,220,70,0,180,120,80,670
"1518",14881,40,0,0,60,0,30,130
"1519",14882,500,350,130,420,330,210,1940
"1520",14883,620,210,30,540,330,210,1940
"1521",14884,60,0,0,30,40,30,160
"1522",14885,110,30,0,90,40,30,300
"1523",14886,940,560,150,760,520,360,3290
"1524",14889,230,80,0,200,110,80,700
"1525",14891,710,250,40,540,330,180,2050
"1526",14892,1340,360,60,1010,560,310,3640
"1527",14894,220,70,0,180,100,60,630
"1528",14895,1520,420,70,990,550,370,3920
"1529",14897,130,50,0,80,60,30,350
"1530",14898,200,60,0,160,90,50,560
"1531",14901,2460,350,50,1510,640,370,5380
"1532",14903,1110,420,180,970,590,340,3610
"1533",14904,2760,400,20,2100,940,530,6750
"1534",14905,1330,700,190,970,670,480,4340
"1535",99999,24980,12870,10000,18770,11970,7790,86380
